#################-------------------------------
#     T         #######-------------------------
##   S     T   K      ##------------------------
##     T           T   #########################
#T                         K                  ##
#       K           ############    T         ##
##########     WWWW##----------#         TT   ##
---------#    WWWWWWWWWWW------###            ##
-T--T----##       #-----WWWWWW---####         ##
-----T---#WW     #--------WWWWWWWWWWWWW       ##
##########WW      #########---------#         ##
#                K        #---T-----#         ##
#       T          K      #---------#     KK  ##
#        ##       ###  T  #---------#         ##
#        ##        ##   ###----T----#         ##
#    K         X    #####--------TT-#         ##
#####################---------------############