START = 2,2
DIRECTION = S
BACKGROUND = mountains
*
#################-------------------------------
#     T         #######-------------------------
##         T          ##------------------------
##     T           T   #########################
#T         WW                                 ##
#           WW      ############    T         ##
##########   WW    ##----------#         TT   ##
---------#    WWWWWWWWWWW------###            ##
-T--T----##       #-----WWWWWW---####         ##
-----T---#WW     #--------WWWWWWWWWWWWW       ##
##########WW      #########---------#         ##
#                         #---T-----#         ##
#       T                 #---------#         ##
#        ##       ###  T  #---------#         ##
#        ##        ##   ###----T----#         ##
#                   #####--------TT-#         ##
#####################---------------############