DIRECTION = SOUTH
BACKGROUND = mountains
*
#################-------------------------------
#     T         #######-------------------------
##   S     T   K      ##------------------------
##     T           T   #########################
#T         WW              K                  ##
#       K   WW      ############    T         ##
##########   WW    ##----------#         TT   ##
---------#    WWWWWWWWWWW------###            ##
-T--T----##       #-----WWWWWW---####         ##
-----T---#WW     #--------WWWWWWWWWWWWW       ##
##########WW      #########---------#         ##
#                K        #---T-----#         ##
#       T          K      #---------#     KK  ##
#        ##       ###  T  #---------#         ##
#        ##        ##   ###----T----#         ##
#    K         X    #####--------TT-#         ##
#####################---------------############