START = 2,2
*
#################----------      
#     T         #######----
##         T          ##---
##     T           T   ####
#T         WW             #
#           WW      #######
##########   WW    ##------
---------#    WWWW##WWWWW--
-T--T----##       #-----WWW
-----T---#WW     #--------W
##########WW      #########
#                         #
#       T                 #
#        ##       ###  T  #
#        ##        ##   ###
#                   #####--
########     ########------
#     T         #######----
##         T          ##---
##     T           T   ####
#T         WW             #
#           WW      #######
##########   WW    ##------
---------#    WWWW##WWWWW--
-T--T----##       #-----WWW
-----T---#WW     #--------W
##########WW      #########
#                         #
#       T                 #
#        ##       ###  T  #
#        ##        ##   ###
#                   #####--
###########     #####------      
#     T         #######----
##         T          ##---
##     T           T   ####
#T         WW             #
#           WW      #######
##########   WW    ##------
---------#    WWWW##WWWWW--
-T--T----##       #-----WWW
-----T---#WW     #--------W
##########WW      #########
#                         #
#       T                 #
#        ##       ###  T  #
#        ##        ##   ###
#                   #####--
########     ########------
#     T         #######----
##         T          ##---
##     T           T   ####
#T         WW             #
#           WW      #######
##########   WW    ##------
---------#    WWWW##WWWWW--
-T--T----##       #-----WWW
-----T---#WW     #--------W
##########WW      #########
#                         #
#       T                 #
#        ##       ###  T  #
#        ##        ##   ###
#                   #####--
#####################------
