##############
#            #
# T      T   #
#    T       #
#       WWW  #
#  T    WWW  #
# T     WWW  #
#            #
##############