#################
#     T         #######
##         T          ##
##     T           T   ####
#T         WW             #
#           WW      #######
##########   WW    ##
#        #    WWWW##
#        ##       #
#         #########
